111111111
1E0C0E001
1P000Z0E1
100C00001
111111111