11111111111
11110C01111
11110Z01111
11110001111
1111Z0Z1111
1Z0000000Z1
1C0Z0P0Z0E1
100000000Z1
11110001111
11110001111
11110001111
11111111111