11111111111111111111111111111111111111111111111111111111111111111111111
11111111111111111111111111111111111111111111111110000011111111111111111
10000000000000000000000000000000000000000000000000000000000000000111111
111111111111111111P1111111111111101111111111111111111111111111111111111
111111111CCC0000000000000000000000000000000000000000000000E111111111111
11111111111111111111111111111111111111111111111111111111111111111111111