111111111
1E0C00Z01
100000Z01
1P0C000C1
111111111