1111111111
111PCC01E1
1111111111
