1111111
11P0CE1
1111111
1111111



1111111